






11111111111111111111111111
10001000000001110111110011
100T1000000001111101100111
10001000T00001100010001111
100010000000T0000000010011
1000100T000001100000111011
10001000000E00011011101111
1000100T000001110001101111
10000011111001110E11101111
10T00110000000P00100010111
11111000110011111011101111
10000100100000000001001011
10000110000C00000100101101
10000110000001110011110111
1000011000000T000100110111
100001100000000000T0000001
11111111111111111111111111








