11111111111111111111111
100010000000C1111111111
10000011111001111111111
1P00011E000000000111111
10000110000000000111111
10000110000C00000111111
10000110000001111111111
100001100C0000000111111
11111111111111111111111
11111111111111111111111