11111111111111111
1000000P000000001
11111100000011111
11111111111111111