






111111111111111111111111
100010000000C11101111111
100010000C00011111011111
100010000000C11111101111
100010000000C00000000111
100010000000C00000111011
100010000000C11011101111
1000100E0000C11111101111
100000111110011111101111
1P00011E0000000001010111
111111111111111011101111
100001100C00000001111011
10000110000C000001111101
100001100000011111110111
100001100C00000001110111
100001100C00000000000001
111111111111111111111111








