11111111111111111111
100010000000C1111111
10000011111001111111
1P00011E000000000111
10000110000000000111
10000110000C00000111
10000110000001111111
100001100C0000000111
11111111111111111111