1111111111111111111111111111111111111111111111
1000100000001110000110000000000001110111110E11
1000100000001000000000000000000001111101100111
1000100000001000000000000000000001100010001111
10001000000000000000000000C0000000000000010011
1000100000000000000011000000000001100000111011
10001000000E0000000011000000000000011011101111
1000100000000000000000000000000001110001101111
100C00111110000000000E000000000001110E11101111
10000110000000000C0000000000000000P00100010111
1111100011000000000000000000000011111011101111
1000010010000000010000000000000000000001001011
1000011000000000010000000000000000000100101101
1000011000000000010000000000000001110011110111
100001100000C0000100000000C0000000000100110111
1000011000000000010000000000000000000000000001
1111111111111111111111111111111111111111111111