11111111111111111111111111111111
110000011110000000001110C000ET11
10PCE000000000111100000000110001
10000001111000TC0T00000011100001
10T00001110000TTTT0010000010T001
1000TC0010000000000010000C0000E1
11111111111111111111111111111111